1111111111
10000000C1
100E0P0001
1000000001
1000000001
1111111111