11111111111111111111111
10000000000000000000001
1000000000P00C0C0E00001
10000000000000000000001
11111111111111111111111