111111111111111111111111111111111111
1000C000000000000C000000000000000001
1000000000C111111000P000000000000001
100000000000000000000E00000C00000001
100011100000000000000000000000000001
100000000C11111100000000000000000001
1000000000C0000000C00000000000000001
111111111111111111111111111111111111