11111111111111111111111111
100000000000000000000000C1
1000000111111111000E000001
10000111111100000111110001
100P0000000000000000000001
11111111111111111111111111